//MAP CONVERTED BY dmm2tgm.py THIS HEADER COMMENT PREVENTS RECONVERSION, DO NOT REMOVE
"aw" = (
/obj/effect/landmark/mapGenerator/rogue/bog,
/turf/closed/mineral/rogue/bedrock,
/area/rogue/outdoors/bog)
"dP" = (
/obj/structure/fluff/statue/small,
/obj/effect/decal/cobbleedge,
/turf/open/floor/rogue/greenstone,
/area/rogue/outdoors/bog)
"gS" = (
/turf/open/water/swamp/deep,
/area/rogue/outdoors/bog)
"hh" = (
/turf/open/transparent/openspace,
/area/rogue/outdoors/mountains)
"kc" = (
/turf/open/floor/rogue/blocks/green,
/area/rogue/outdoors/bog)
"kZ" = (
/turf/open/floor/rogue/grass,
/area/rogue/outdoors/bog)
"tg" = (
/turf/closed/mineral/rogue,
/area/rogue/outdoors/bog)
"tG" = (
/turf/closed/mineral/rogue/gemeralds,
/area/rogue/outdoors/mountains)
"xs" = (
/mob/living/carbon/human/species/skeleton/npc/no_equipment{
	real_name = "Drowned";
	custom_descriptors = "A skeleton whose ribcage is filled with leeches."
	},
/turf/open/water/swamp/deep,
/area/rogue/outdoors/bog)
"xL" = (
/obj/structure/kneestingers,
/turf/open/floor/rogue/grass,
/area/rogue/outdoors/bog)
"yK" = (
/turf/closed/mineral/rogue/bedrock,
/area/rogue/outdoors/mountains)
"BW" = (
/obj/effect/landmark/mapGenerator/rogue/mountain,
/turf/closed/mineral/rogue/bedrock,
/area/rogue/outdoors/mountains)
"CR" = (
/turf/open/floor/rogue/naturalstone,
/area/rogue/outdoors/mountains)
"Gh" = (
/turf/open/water/swamp,
/area/rogue/outdoors/bog)
"Hd" = (
/obj/structure/flora/roguetree,
/turf/open/water/swamp/deep,
/area/rogue/outdoors/bog)
"La" = (
/turf/open/floor/rogue/dirt,
/area/rogue/outdoors/bog)
"MQ" = (
/turf/closed/mineral/rogue/bedrock,
/area/rogue/outdoors/bog)
"Oa" = (
/obj/structure/flora/roguetree/burnt,
/turf/open/floor/rogue/dirt,
/area/rogue/outdoors/bog)
"Ph" = (
/turf/open/floor/rogue/greenstone,
/area/rogue/outdoors/bog)
"UX" = (
/obj/effect/decal/cobbleedge,
/turf/open/floor/rogue/greenstone,
/area/rogue/outdoors/bog)
"YN" = (
/obj/structure/kneestingers,
/turf/open/floor/rogue/dirt,
/area/rogue/outdoors/bog)

(1,1,1) = {"
MQ
MQ
MQ
MQ
MQ
MQ
MQ
MQ
MQ
MQ
MQ
MQ
MQ
MQ
MQ
MQ
MQ
MQ
MQ
MQ
MQ
MQ
MQ
MQ
MQ
MQ
MQ
MQ
MQ
MQ
MQ
aw
"}
(2,1,1) = {"
tg
tg
tg
tg
tg
La
kZ
La
tg
tg
kZ
La
tg
tg
tg
tg
tg
La
La
tg
tg
tg
tg
tg
tg
tg
tg
tg
tg
tg
tg
MQ
"}
(3,1,1) = {"
tg
tg
tg
tg
La
kZ
kZ
La
La
La
kZ
kZ
tg
tg
tg
La
La
kZ
kZ
La
tg
tg
tg
tg
tg
tg
tg
tg
tg
tg
tg
MQ
"}
(4,1,1) = {"
tg
tg
La
kZ
kZ
kZ
La
La
La
La
La
kZ
kZ
tg
tg
YN
kZ
kZ
La
La
La
La
La
La
La
tg
tg
tg
tg
tg
tg
MQ
"}
(5,1,1) = {"
kZ
La
La
La
La
La
La
kZ
kZ
kZ
Oa
La
La
tg
tg
La
kZ
La
La
Gh
Gh
La
Oa
La
La
La
tg
tg
tg
tg
tg
MQ
"}
(6,1,1) = {"
Gh
La
La
La
Oa
La
kZ
La
La
xL
YN
La
La
La
La
La
kZ
La
La
La
Gh
Gh
Gh
kZ
La
La
La
tg
tg
tg
tg
MQ
"}
(7,1,1) = {"
La
kZ
La
La
kZ
YN
La
kZ
kZ
kZ
La
La
La
kZ
La
La
La
La
La
La
La
kZ
Gh
kZ
kZ
La
La
La
La
tg
tg
MQ
"}
(8,1,1) = {"
La
kZ
kZ
La
kZ
xL
La
La
La
kZ
La
La
La
kZ
kZ
La
La
Oa
kZ
kZ
La
kZ
La
La
kZ
kZ
La
La
La
La
tg
MQ
"}
(9,1,1) = {"
La
La
kZ
La
La
kZ
kZ
Oa
La
kZ
La
La
La
La
kZ
kZ
La
La
La
kZ
La
La
La
La
La
kZ
La
La
Oa
La
tg
MQ
"}
(10,1,1) = {"
La
La
kZ
kZ
La
La
kZ
kZ
La
La
La
La
La
La
La
kZ
kZ
Gh
Gh
Gh
Gh
Gh
Gh
Gh
Gh
Gh
Gh
Gh
Gh
Gh
Gh
MQ
"}
(11,1,1) = {"
kZ
Oa
La
La
La
La
kZ
La
Gh
Gh
Gh
Gh
Gh
Gh
Gh
Gh
Gh
Gh
Gh
Gh
Gh
Gh
Gh
Gh
Gh
Gh
Gh
Gh
Gh
Gh
Gh
MQ
"}
(12,1,1) = {"
kZ
La
La
La
La
La
La
La
Gh
Gh
Gh
Gh
Gh
Gh
Gh
Gh
Gh
Gh
Gh
Gh
Gh
Gh
Gh
Gh
Gh
Gh
Gh
Gh
Gh
Gh
Gh
MQ
"}
(13,1,1) = {"
kZ
La
YN
kZ
kZ
kZ
La
La
Gh
Gh
Gh
Gh
Gh
gS
gS
gS
gS
gS
kc
kc
kc
gS
gS
gS
gS
gS
gS
gS
gS
gS
gS
MQ
"}
(14,1,1) = {"
La
La
kZ
kZ
La
kZ
kZ
Gh
Gh
Gh
Gh
Gh
gS
gS
gS
gS
gS
gS
kc
kc
kc
Ph
Ph
gS
gS
gS
gS
gS
gS
gS
gS
MQ
"}
(15,1,1) = {"
La
La
La
La
La
Gh
Gh
Gh
Gh
Gh
Gh
gS
gS
gS
gS
gS
gS
gS
kc
kc
kc
Ph
dP
gS
gS
gS
gS
gS
gS
gS
gS
MQ
"}
(16,1,1) = {"
La
Gh
Gh
Gh
Gh
Gh
Gh
Gh
Gh
Gh
gS
gS
gS
gS
gS
gS
gS
gS
kc
kc
kc
Ph
UX
gS
gS
gS
xs
gS
gS
gS
gS
MQ
"}
(17,1,1) = {"
Gh
Gh
Gh
Gh
Gh
Gh
Gh
Gh
Gh
gS
gS
gS
gS
gS
gS
gS
gS
gS
kc
kc
kc
Ph
UX
gS
gS
gS
gS
gS
gS
gS
gS
MQ
"}
(18,1,1) = {"
Gh
Gh
Gh
Gh
Gh
Gh
Gh
gS
gS
gS
gS
gS
gS
gS
gS
gS
gS
gS
Ph
Ph
Ph
Ph
UX
gS
gS
gS
gS
gS
gS
gS
gS
MQ
"}
(19,1,1) = {"
gS
gS
gS
gS
gS
gS
gS
gS
gS
gS
gS
gS
gS
gS
gS
xs
gS
gS
Ph
Ph
Ph
Ph
UX
gS
gS
gS
gS
gS
gS
gS
gS
MQ
"}
(20,1,1) = {"
gS
gS
gS
gS
gS
gS
gS
gS
gS
gS
gS
gS
gS
gS
gS
gS
gS
gS
Ph
Ph
Ph
Ph
UX
gS
gS
gS
gS
gS
gS
gS
gS
MQ
"}
(21,1,1) = {"
gS
gS
gS
gS
gS
gS
gS
gS
gS
gS
gS
gS
gS
gS
gS
gS
gS
gS
Ph
Ph
Ph
Ph
UX
gS
gS
gS
gS
gS
gS
gS
gS
MQ
"}
(22,1,1) = {"
gS
gS
gS
gS
gS
gS
gS
gS
gS
gS
gS
gS
gS
gS
gS
gS
gS
gS
Ph
Ph
Ph
Ph
Ph
gS
gS
gS
gS
gS
gS
gS
gS
MQ
"}
(23,1,1) = {"
gS
gS
gS
gS
gS
gS
gS
gS
gS
gS
gS
gS
gS
gS
gS
gS
gS
gS
Ph
Ph
Ph
Ph
Ph
gS
gS
gS
gS
gS
gS
gS
gS
MQ
"}
(24,1,1) = {"
gS
gS
gS
gS
gS
gS
gS
gS
gS
gS
gS
gS
gS
gS
gS
gS
gS
gS
Ph
Ph
Ph
Ph
Ph
gS
gS
gS
Hd
gS
gS
gS
gS
MQ
"}
(25,1,1) = {"
gS
xs
gS
gS
gS
gS
gS
gS
gS
gS
gS
gS
gS
gS
gS
gS
Hd
gS
gS
gS
gS
gS
gS
gS
gS
gS
gS
gS
gS
gS
gS
MQ
"}
(26,1,1) = {"
gS
gS
gS
gS
gS
gS
gS
gS
gS
gS
gS
gS
gS
gS
gS
gS
gS
gS
gS
gS
gS
gS
gS
gS
gS
gS
gS
gS
gS
gS
gS
MQ
"}
(27,1,1) = {"
gS
gS
gS
gS
gS
tg
tg
gS
gS
gS
gS
gS
gS
gS
gS
gS
gS
gS
gS
gS
gS
gS
gS
gS
gS
gS
gS
gS
gS
gS
gS
MQ
"}
(28,1,1) = {"
gS
gS
gS
gS
tg
tg
tg
tg
tg
tg
gS
gS
gS
gS
gS
gS
gS
gS
gS
gS
gS
gS
gS
gS
gS
gS
gS
gS
gS
gS
gS
MQ
"}
(29,1,1) = {"
gS
gS
gS
gS
tg
tg
tg
tg
tg
tg
gS
gS
gS
gS
gS
gS
gS
gS
gS
gS
gS
gS
gS
xs
gS
gS
gS
gS
gS
gS
gS
MQ
"}
(30,1,1) = {"
gS
gS
gS
gS
gS
tg
tg
tg
tg
tg
gS
gS
gS
gS
gS
gS
gS
gS
gS
gS
gS
gS
gS
gS
gS
gS
gS
gS
gS
gS
gS
MQ
"}
(31,1,1) = {"
gS
gS
gS
gS
tg
tg
tg
tg
tg
tg
tg
tg
gS
gS
gS
gS
gS
gS
gS
gS
gS
gS
gS
gS
gS
gS
gS
gS
gS
gS
gS
MQ
"}
(32,1,1) = {"
gS
gS
gS
gS
gS
tg
tg
tg
tg
tg
tg
gS
gS
gS
gS
gS
gS
gS
gS
gS
gS
gS
gS
gS
gS
gS
gS
gS
gS
gS
gS
MQ
"}

(1,1,2) = {"
yK
yK
yK
yK
yK
yK
yK
yK
yK
yK
yK
yK
yK
yK
yK
yK
yK
yK
yK
yK
yK
yK
yK
yK
yK
yK
yK
yK
yK
yK
yK
BW
"}
(2,1,2) = {"
hh
hh
hh
hh
hh
hh
hh
hh
hh
hh
hh
hh
hh
hh
hh
hh
hh
hh
hh
hh
hh
hh
hh
hh
hh
hh
hh
hh
hh
hh
hh
yK
"}
(3,1,2) = {"
hh
hh
hh
hh
hh
hh
hh
hh
hh
hh
hh
hh
hh
hh
hh
hh
hh
hh
hh
hh
hh
hh
hh
hh
hh
hh
hh
hh
hh
hh
hh
yK
"}
(4,1,2) = {"
hh
hh
hh
hh
hh
hh
hh
hh
hh
hh
hh
hh
hh
hh
hh
hh
hh
hh
hh
hh
hh
hh
hh
hh
hh
hh
hh
hh
hh
hh
hh
yK
"}
(5,1,2) = {"
hh
hh
hh
hh
hh
hh
hh
hh
hh
hh
hh
hh
hh
hh
hh
hh
hh
hh
hh
hh
hh
hh
hh
hh
hh
hh
hh
hh
hh
hh
hh
yK
"}
(6,1,2) = {"
hh
hh
hh
hh
hh
hh
hh
hh
hh
hh
hh
hh
hh
hh
hh
hh
hh
hh
hh
hh
hh
hh
hh
hh
hh
hh
hh
hh
hh
hh
hh
yK
"}
(7,1,2) = {"
hh
hh
hh
hh
hh
hh
hh
hh
hh
hh
hh
hh
hh
hh
hh
hh
hh
hh
hh
hh
hh
hh
hh
hh
hh
hh
hh
hh
hh
hh
hh
yK
"}
(8,1,2) = {"
hh
hh
hh
hh
hh
hh
hh
hh
hh
hh
hh
hh
hh
hh
hh
hh
hh
hh
hh
hh
hh
hh
hh
hh
hh
hh
hh
hh
hh
hh
hh
yK
"}
(9,1,2) = {"
hh
hh
hh
hh
hh
hh
hh
hh
hh
hh
hh
hh
hh
hh
hh
hh
hh
hh
hh
hh
hh
hh
hh
hh
hh
hh
hh
hh
hh
hh
hh
yK
"}
(10,1,2) = {"
hh
hh
hh
hh
hh
hh
hh
hh
hh
hh
hh
hh
hh
hh
hh
hh
hh
hh
hh
hh
hh
hh
hh
hh
hh
hh
hh
hh
hh
hh
hh
yK
"}
(11,1,2) = {"
hh
hh
hh
hh
hh
hh
hh
hh
hh
hh
hh
hh
hh
hh
hh
hh
hh
hh
hh
hh
hh
hh
hh
hh
hh
hh
hh
hh
hh
hh
hh
yK
"}
(12,1,2) = {"
hh
hh
hh
hh
hh
hh
hh
hh
hh
hh
hh
hh
hh
hh
hh
hh
hh
hh
hh
hh
hh
hh
hh
hh
hh
hh
hh
hh
hh
hh
hh
yK
"}
(13,1,2) = {"
hh
hh
hh
hh
hh
hh
hh
hh
hh
hh
hh
hh
hh
hh
hh
hh
hh
hh
hh
hh
hh
hh
hh
hh
hh
hh
hh
hh
hh
hh
hh
yK
"}
(14,1,2) = {"
hh
hh
hh
hh
hh
hh
hh
hh
hh
hh
hh
hh
hh
hh
hh
hh
hh
hh
hh
hh
hh
hh
hh
hh
hh
hh
hh
hh
hh
hh
hh
yK
"}
(15,1,2) = {"
hh
hh
hh
hh
hh
hh
hh
hh
hh
hh
hh
hh
hh
hh
hh
hh
hh
hh
hh
hh
hh
hh
hh
hh
hh
hh
hh
hh
hh
hh
hh
yK
"}
(16,1,2) = {"
hh
hh
hh
hh
hh
hh
hh
hh
hh
hh
hh
hh
hh
hh
hh
hh
hh
hh
hh
hh
hh
hh
hh
hh
hh
hh
hh
hh
hh
hh
hh
yK
"}
(17,1,2) = {"
hh
hh
hh
hh
hh
hh
hh
hh
hh
hh
hh
hh
hh
hh
hh
hh
hh
hh
hh
hh
hh
hh
hh
hh
hh
hh
hh
hh
hh
hh
hh
yK
"}
(18,1,2) = {"
hh
hh
hh
hh
hh
hh
hh
hh
hh
hh
hh
hh
hh
hh
hh
hh
hh
hh
hh
hh
hh
hh
hh
hh
hh
hh
hh
hh
hh
hh
hh
yK
"}
(19,1,2) = {"
hh
hh
hh
hh
hh
hh
hh
hh
hh
hh
hh
hh
hh
hh
hh
hh
hh
hh
hh
hh
hh
hh
hh
hh
hh
hh
hh
hh
hh
hh
hh
yK
"}
(20,1,2) = {"
hh
hh
hh
hh
hh
hh
hh
hh
hh
hh
hh
hh
hh
hh
hh
hh
hh
hh
hh
hh
hh
hh
hh
hh
hh
hh
hh
hh
hh
hh
hh
yK
"}
(21,1,2) = {"
hh
hh
hh
hh
hh
hh
hh
hh
hh
hh
hh
hh
hh
hh
hh
hh
hh
hh
hh
hh
hh
hh
hh
hh
hh
hh
hh
hh
hh
hh
hh
yK
"}
(22,1,2) = {"
hh
hh
hh
hh
hh
hh
hh
hh
hh
hh
hh
hh
hh
hh
hh
hh
hh
hh
hh
hh
hh
hh
hh
hh
hh
hh
hh
hh
hh
hh
hh
yK
"}
(23,1,2) = {"
hh
hh
hh
hh
hh
hh
hh
hh
hh
hh
hh
hh
hh
hh
hh
hh
hh
hh
hh
hh
hh
hh
hh
hh
hh
hh
hh
hh
hh
hh
hh
yK
"}
(24,1,2) = {"
hh
hh
hh
hh
hh
hh
hh
hh
hh
hh
hh
hh
hh
hh
hh
hh
hh
hh
hh
hh
hh
hh
hh
hh
hh
hh
hh
hh
hh
hh
hh
yK
"}
(25,1,2) = {"
hh
hh
hh
hh
hh
hh
hh
hh
hh
hh
hh
hh
hh
hh
hh
hh
hh
hh
hh
hh
hh
hh
hh
hh
hh
hh
hh
hh
hh
hh
hh
yK
"}
(26,1,2) = {"
hh
hh
hh
hh
hh
hh
hh
hh
hh
hh
hh
hh
hh
hh
hh
hh
hh
hh
hh
hh
hh
hh
hh
hh
hh
hh
hh
hh
hh
hh
hh
yK
"}
(27,1,2) = {"
hh
hh
hh
hh
hh
CR
CR
hh
hh
hh
hh
hh
hh
hh
hh
hh
hh
hh
hh
hh
hh
hh
hh
hh
hh
hh
hh
hh
hh
hh
hh
yK
"}
(28,1,2) = {"
hh
hh
hh
hh
CR
tG
tG
CR
CR
CR
hh
hh
hh
hh
hh
hh
hh
hh
hh
hh
hh
hh
hh
hh
hh
hh
hh
hh
hh
hh
hh
yK
"}
(29,1,2) = {"
hh
hh
hh
hh
CR
tG
tG
CR
tG
tG
CR
hh
hh
hh
hh
hh
hh
hh
hh
hh
hh
hh
hh
hh
hh
hh
hh
hh
hh
hh
hh
yK
"}
(30,1,2) = {"
hh
hh
hh
hh
hh
CR
tG
tG
tG
tG
CR
hh
hh
hh
hh
hh
hh
hh
hh
hh
hh
hh
hh
hh
hh
hh
hh
hh
hh
hh
hh
yK
"}
(31,1,2) = {"
hh
hh
hh
hh
CR
tG
tG
tG
tG
tG
tG
CR
hh
hh
hh
hh
hh
hh
hh
hh
hh
hh
hh
hh
hh
hh
hh
hh
hh
hh
hh
yK
"}
(32,1,2) = {"
hh
hh
hh
hh
hh
CR
CR
CR
CR
CR
CR
hh
hh
hh
hh
hh
hh
hh
hh
hh
hh
hh
hh
hh
hh
hh
hh
hh
hh
hh
hh
yK
"}
